Artist	Title
Above & Beyond, Justine Suissa	Bigger Than All Of Us - Above & Beyond Club Mix
Azaleh	Abyssal Calls
BAYNK	When I Think About Us
BOP, Unquote	Drifting Away
Bassi Fox	STOP (what if you fly?)
CRUSH3d	Slug
CRi, Bernache	From Me - CRi Remix
Cameo Blush	Essa
Cameo Blush	Here
Cameo Blush	Just Concentrate
Cameo Blush	One Chance
Cameo Blush	Violet
Chet Porter	What You Need
CloudNone	Beacon
Contrecoeur	Pretty Face
DJ BORING, SWIM	Stay With Me
DJ Planet Express	Breathe Me In
DJ Seinfeld	Hopecore
Disco Lines, Tinashe	No Broke Boys
Estiva, Trilucid	All Night - Trilucid Remix
Feist	Mushaboom - Postal Service Remix
Fred again.., Romy, HAAi	Lights Out
Froman	No More
HAAi, Alexis Taylor, ILĀ, Trans Voices	New Euphoria
HVOB	Void
Harry Hayes	More of You
Jack Kelly	Unfold
Kollektiv Turmstrasse	Luechtoorn
Kyau & Albert, Boss Axis	Kiksu - Boss Axis Remix
LEV, Lake Taro	You'll Be Okay
Lane 8, Arctic Lake, Sultan + Shepard	Say The Word - Sultan + Shepard Remix
Laxcity	Daydream
Luke Abbott	Grumble
M.O.S.	Beyond Your Mind
MYRNE	Afterglows
MYRNE	Koel
Marley Carroll	One More Year
Matt Fax	Ascend
Max Cooper, Wilderthorn	Nanotech
Montee	98 Sunset
Montee	feels like you
Mord Fustang	Flower With No Name
MÒZÂMBÎQÚE, il:lo	Inner Voice - Remix
Nathan Fake	Outhouse - Main Mix
No Mana, Jessica Ess	Panic
Ordley	4EVA
Petit Biscuit, Lizzy Land	Everything In Its Right Place
Player Dave	goin under
Player Dave, Next To Blue	No One Can See
Player Dave, sumthin sumthin	Fracture
Pretty Girl	Hahaha
QUIX	Arpeggio (Interlude)
Rob Clouth	The Vacuum State
Romy, HAAi, Fred again..	Lights Out (feat. Fred again..) - HAAi Remix
SWIM	First Day of the Year
Sonny Side Up	Ghosted
Sound of Fractures	My Love For You
Submotion Orchestra	Amira
Syence	the distance
TDJ, fknsyd	Open Air
Thomas Adagio, Gigamesh	Stand Up
Thylacine	Dokido (with Ozohere's Himba)
Weval	MOVEMENT
edapollo	Aurora
edapollo, Pool Girl	I liked it - edapollo edit
wes mills	flying high