Artist	Title
Arlo, Emi Grace	Besides You
Azaleh	Abyssal Calls
Baril, Ugolino	Falling For You
Barry Can't Swim	Still Riding
Booka Shade	P.I.N. 4
CRi, Everyone You Know, Qrion	Miroir Miroir - Qrion Remix
Catching Flies	WORRY.
Chrystal, NOTION	The Days - NOTION Remix
CloudNone, Linney	Quiet Of My Mind
Covex, Fi Sullivan	Another Night
D.O.D	Every Step
DJ Seinfeld, Confidence Man	Now U Do - Edit
Daniel Joshua, Charles Oliver	Hivemind - Charles Oliver Remix
Echo Juliet, Gold Panda	Eating the Rich - Gold Panda Remix
Elderbrook, nimino	Ain’t Losing You
Funkagenda	One Day At A Time - Radio Edit
HAELIUM	Somehow
Harrison	Here Comes the Rush
JUICEB☮X	Gypsy Crystal
Jack Shore, Azuzu, Juma Iking, Jeroen Antoine	Nijmegen 09.12.24 (feat. Jeroen Antoine)
John Summit, Echoes	Human (feat. Echoes)
Keenan Mathias	Get Over
Kidnap	Birds That Fly
Kidnap	Untroubled
Kidnap, Rival Consoles	Birds That Fly - Rival Consoles Remix
Mark Tarmonea, Yannek Maunz	Prelusion
Memphis LK, Willaris. K	Say
Mild Minds	GEMINI
Montee	98 Sunset
Møme	Playground
NOTION, Charlotte Plank	TEMPORARY FRIENDS
Ninajirachi	Undo U
O'Flynn, Frazer Ray	Troopa
Oxia	Domino
Pretty Girl	The Only Way Out Is Through
RÜFÜS DU SOL	Levitating
SWIM	ID - dont - [12/22]
SWIM	U Were Mine
SkiiTour, Badger	We Belong - Badger Remix
Slayyyter	Mine
Sound of Fractures	They Don't Know Me
Swimming Paul	Lost
Tover, Arlo, Emi Grace	the little things
Tristam	I Remember
Venjent, Oktae	Calling For You
Vylet Pony	ANTONYMPH
barking continues	can we stay friends?
nimino	I Only Smoke When I Drink