Artist	Title
Apparat	Arcadia
Astrale	How to Observe
BAYNK, Cub Sport	Mine
Brainwaltzera	Fwd: Re: late (Ref.: karoshi)
Brecon	Half Light
Cameo Blush	One Chance
Eero Johannes	HAL Manifesto
Henrik Lindstrand, Manu Delago	Hallonlandet (Reimagined by Manu Delago)
Indian Wells	Closer
Indian Wells	Heart Of Lights
Jim Perkins, Anna De Bruin	Footsteps
Jinjé	Cinétique
Joe Ford, Memtrix	Out of Place
Joep Beving	Hanging D
Kai Whiston, Iglooghost	Lux 2
Kelpe	Cut It Upwards
Mammal Hands	Ithaca
Marc Romboy	La Lune Et L'étoile
Max Cooper	Incompleteness
Max Cooper	Pulse At The Centre Of Being
Max Cooper	Repetition
Max Cooper, Felix Gerbelot	On Being
Max Cooper, Tom Hodge	Symmetry
Minihi	Minquiers
Mooncake	L5
Mount Kimbie	Break Well
Move 78, Aver	Follow the Earworm
Mr. Bill	Not Behd
Mr. Bill, Funi	Screening
Mr. Bill, Of The Trees	Pish Posh
Mr. Bill, Qebrus	2ct7
Mr. Bill, Skope, Zebbler Encanti Experience	2020 - Zebbler Encanti Experience Remix
Mr. Bill, premo	Nut Bleeding Dynamics
Nils Frahm	#2
No Spirit, Sátyr	Arrival
Perturbator	God Complex
Perturbator	Lustful Sacraments
Plaid	Do Matter
Plaid, Benet Walsh	Eyen
Reid Willis	She Dreamt Her Hands Were Constellations
Rival Consoles	Winter's Lament
Rutger Hoedemaekers	Ring Out The Darkness
Ryan Davis, Alex Banks	Sequence 1
Soukah	Life Without Meaning
Twenty One Pilots	Stressed Out
Ultraísta, Justin Martin	Smalltalk (Justin Martin Remix)
Varsity Star	Christmas Lights
Woulg	CI-395
Woulg	Memory Relapse
clipping.	Story 2
deadmau5	Pets
trentemøller	Take Me Into Your Skin
trentemøller	Trnt
中村佳穂	忘れっぽい天使