Artist	Title
Alex Banks	Falling Down
Athletic Progression	WHITE CRAYON
Avishai Cohen, Shai Maestro, Mark Guiliana	Pinzin Kinzin
Blumen, Luke Martin	Ossycles
Blumen, Theo Young, Greg Wakeman	Murk
Clément Belio	Chromatic Curtain
Coolgirl, Varsity Star	Gaussian Blur - Varsity Star Remix
Dark Sky	Field Tower
Dawn of Midi	Io
Echo Map	Ember
Flawed Mangoes	The Beginning
Frank Hopkins, Løgømyx	Singular Drift
G Jones	Iridescent Leaves Floating Downstream
Immortal Onion	Eye Tracking
In Embers	Binary Stars
Indian Wells	New Ruins
James Shinra	hive.mind
Jolynn J Chin	Holy Poly
Jordan Rakei	Wings
Kessler	Old Wives Tale
Kyle Preston	Gutenberg
Lilly Legit	Immersion
Mad Zach	Belittle No One
Maliki	Complicated By Both
Mammal Hands	Ithaca
Montee	feels like you
Mouth Water	EXIT - Plaid Remix Instrumental
Mr. Bill	Sisyphus
Nicolas Bougaïeff	Lightness
No Mana	Should’ve Brought My Switch
Non Square	You Me & Them
Népal, Nekfeu	En face
Pogo	Ganbatte
Robot Koch, Kristjan Järvi, Nordic Pulse	Liquid
Sevish	Gleam
Thylacine	Piany Pianino
Tigran Hamasyan	Ara Resurrected
Tigran Hamasyan	The Grid
Tigran Hamasyan, Tosin Abasi	Vortex (feat. Tosin Abasi)
Tom VR	Chaotic Folds
Yvette Young	Jolt
clipping.	Story 2
delay_ok	Yanavy Obaki