Artist	Title
A Path Untold	The Air We Breathe
A.M.R	Portrait Of You
Aaron Smith, Luvli, Krono	Dancin - Krono Remix
Abe	Asgard
Above & Beyond, Justine Suissa	Bigger Than All Of Us - Above & Beyond Club Mix
Alex Banks	Tephra
Alex Banks, Maya Wolff	Elevate - Edit
Alps 2, Throwing Snow	Blur Vid - Throwing Snow's Mix
Ambassadeurs	Clarion
Ambassadeurs	Nocturnes
April, ATRIP	54321 - ATRIP Remix
Arthur Hnatek	Chando
Azaleh	Abyssal Calls
BICEP	Sundial
BICEP, Hammer	CHROMA 007 STEALL
BT	Kintsugi
BUDD	Ghost
Baalti, Tom VR	Staying In Touch - Tom VR Sunrise Mix
Baril	I Need You
Barry Can't Swim	Still Riding
Bassi Fox	STOP (what if you fly?)
Ben Böhmer, Timo Jahns	Lifespan
Ben Prunty	A.C.I.D.
Boards of Canada	New Seeds
Bonobo	Linked
Booka Shade	Moonbow
Boreta	Jake's Fire
Boss Axis	Seven Hills
Boucle Infinie	Solitude
Braxton	Spaces
CRUSH3d	Slug
CRi	Lonely Romance
CRi	No Mission
CRi, Bernache	From Me - CRi Remix
Catching Flies, Fejká	Iajo
Chet Porter	What You Need
Chrome Sparks	O, My Perfection
Chrome Sparks	Ride The White Lightning
CloudNone	Welcome to London
CloudNone, Direct	i saw the sine
Cubicolor	Airbeat
DJ BORING, SWIM	Stay With Me
DOT5	Bitter
DOT5	Naomi
Dapayk solo	Breaking The Clouds
Dezko	Ascend - Sped Up
Direct, Exist Strategy	Blueberry
Disco Lines, demotapes	RWEOK?
Dominik Eulberg, Aera	Schwarzhalstaucher - Aera Remix
Durante, CRi	LMK
Dusqk	Gods Garden
Eagle Eyed Tiger	Tessellate
Enfant Sauvage	58500
Errance, Hologramme	Oxytocin
Estiva, Trilucid	All Night - Trilucid Remix
EvenS	Helios
Ewen-lbh	Shade
F.O.O.L	She
Feist	Mushaboom - Postal Service Remix
Fejká	Pulsing
Flint	Feel the Air
Floating Points	Fast Forward
Floating Points	Key103 [a56 edit]
French 79	FOIX
French 79, AK	FOIX - AK remix
Frere	Pushed
Froman	No More
Funtti	Mirror
GHOST DATA	Let Me See
Glass Museum	Rewind
Godford	Better Place
Good Posture, 1-800 GIRLS	Italy - 1-800 Girls Remix
HAAi	Head Above The Parakeets
HAAi, Jon Hopkins, KAM-BU	Always Ascending
HAELIUM	Somehow
Harry Hayes	More of You
Indian Wells	Against Numbers
Indian Wells	New Ruins
Ital Tek	Become Real
JUICEB☮X	Gypsy Crystal
Jacana People	Ankledeep
Jack Kelly	Unfold
Jai Wolf, BANKS, Mild Minds	Don't Look Down (feat. BANKS) [Mild Minds Remix]
Janus Rasmussen, David Bergmüller	Ado
Jasper Tygner, Art School Girlfriend, Pretty Girl	Ready (feat. Art School Girlfriend) [Pretty Girl Remix]
Jean-Michel Jarre, French 79	EPICA TAKE 2
Jinjé	Amya
Jinjé	Too Young for Zorb
Joep Beving, Polynation	Hanging D - Polynation Remix
Juno Mamba	Frequency
KOAN Sound	AlterCast
Kiasmos	Drawn
Kiasmos, Ólafur Arnalds, Janus Rasmussen	Burst
Kidnap	Birds That Fly
Kollektiv Turmstrasse	Luechtoorn
Kyau & Albert, Boss Axis	Kiksu - Boss Axis Remix
LEV, Lake Taro	You'll Be Okay
LUV HRTS	CAN WE DO BETTER?
Lane 8	Atlas
Lane 8	Howling Hand
Lane 8, Grigoré	Pipi Dormir (GDJB Weekly Drive 14)
Lane 8, Rinzen	Higher - Rinzen Remix
Lawrence Hart	Try Repeat
Laxcity	Daydream
Lipless, Blue Noir	Alone
Louf, Otik	Formation - Otik Remix
Luke Abbott	Brazil
Lusine	The Lift
Løgømyx	Cameo Prox
M.O.S.	Beyond Your Mind
MEUTE	Raw
MYRNE	Koel
Marley Carroll	One More Year
Marley Carroll	Shiver
Massane	Summer's End
Matt Fax	Ascend
Max Cooper, Acid Pauli	Lovesong - Acid Pauli Remix
Max Cooper, Rob Clouth	Transcendental Tree Map - Rob Clouth Remix
Mild Minds	DEVOTION
Montee	98 Sunset
Mord Fustang	Flower With No Name
Mr. Bill, Exorbiter	sudo
Murtagh	Rush
MÒZÂMBÎQÚE, il:lo	Inner Voice - Remix
Niven, Throwing Snow	Rositsa Walks - Throwing Snow Remix
No Mana	Memories of Nothing
No Mana	What's Your Wifi
No Mana, Chipzel	Secret Level
No Mana, Isis Rose	Underwater
No Mana, Winnie Ford	House of Cards
Nowfeel	Mercury Rising
OCULA, ATTLAS	Against The Current
ODESZA, Theodore Shapiro	Mammalians Nurturable - ODESZA Severance Remix
Ocoeur	Opposite Sides
Overmono	Everything U Need
Oxart, Daniel Rosenfeld	Aria Math - Remix
Oxia	Domino
Pig&Dan, Siavash	Reasons To Hate You
PolSky, Vessels	Song for the Silver Surfer - Vessels Mix
Polymod	Cycles
Popof	Do You Want Me
Popof	Serenity
Pretty Girl	Forever
Pretty Girl	Hahaha
Pretty Girl	Message
Pretty Girl	My Trust, My Love
Pretty Girl	Rewind
Pretty Girl	The Only Way Out Is Through
QUIX	Arpeggio (Interlude)
Rein	Sun_3hd
Reuben Keeney	Siren Talks
Rodriguez Jr.	Malecón Azul - Extended Mix
Rodriguez Jr.	Synthwave
Ron Flatter	Sherygerry
Rone	Bye Bye Macadam
Ryan Davis	Wannsee
RÜFÜS DU SOL	Break My Love
RÜFÜS DU SOL, Curtis Harding	Surrender (feat. Curtis Harding)
SWIM	First Day of the Year
Shire T	Over You
ShotoStyle	Summer Tryouts
Simon Doty, Ezequiel Arias	Sonoma
Soda Island, RefraQ	Familiar Trails
Sound of Fractures	They Don't Know Me
Sour	Flutter
Square Perception	Nobody knows
Sublab, Azaleh	Opal
Submotion Orchestra	Amira
Subtact	Right Now
Swørn	Unfamiliar
Sysdemes	Syndicate
The Ocean, Nathan Fake	Preboreal - Nathan Fake Rework
Throwing Snow	The Righteous Mind
Throwing Snow, Kid A	Hypnotise
Thylacine	Dokido (with Ozohere's Himba)
Thylacine	Goodnight
Tom VR	Acheless
Tom VR	Acheless - Edit
Tom VR	Siglo X
Tom VR, Midland	Soared Straight Through Me - Midland Remix
Tourist	A Little Bit Further
Tourist	Crush
Tourist	EST
Tourist	Second Nature
Tourist	Speak In Symphony
Tutara Peak	Colour & Pattern
Tycho, nimino	Small Sanctuary - nimino Remix
Uppermost	Love Runway
Valhalla	Resurrection
Varsity Star	Pipes
Victor Ruiz	Beirut
Victor Ruiz	Pura Vida
VØ	Home
Weval	MOVEMENT
Weval	One
Willmo	Fifth
YOUTH 83	Euphoria
YOUTH 83, upusen	Closer
edapollo	Wake Up
fwd/slash	Aural Therapy
i_o	Ghost in the Machine
il:lo	Ink