Artist	Title
A. G. Cook	Lucifer
Aphex Twin	minipops 67 [120.2][source field mix]
Baths	Superstructure
Boards of Canada	Roygbiv
Floating Points	Ocotillo
Floex, Tom Hodge, Prague Radio Symphony Orchestra	Wednesday (Is The New Friday)
Indian Wells	Cascades
Indian Wells	New Ruins
James Holden, The Animal Spirits	Each Moment Like The First
Jon Hopkins	Collider - Remaster 2023
Jon Hopkins, Purity Ring	Breathe This Air
Lorn	Acid Rain
Lusine	Two Dots
Lusine, Sarah McIlwain	Ticking Hands
Martin Rott	Kinetic Theory
Max Cooper	Aleph 2
Nathan Fake	The Sky Was Pink - Holden Remix
Non Square	Sawing Spirits
Reid Willis	Memory Ribbons
Rival Consoles	Articulation
Rival Consoles	I Left the Party
Rob Clouth	Casimir
Rob Clouth	Like a Second Sun
Rone	Bye Bye Macadam
Squarepusher	Beep Street
Telefon Tel Aviv	The Birds
The Flashbulb	Undiscovered Colors
Tourist, Gold Panda	+1
Vaetxh	Crumbling Shuffle
Vessels	Elliptic
Vessels, Anna of the North	Had a Love