Artist	Title
Carbon Killer	The Last Stand
Ewen-lbh	Circular.
F.O.O.L	Conflict
GEN.KLOUD	ERROR
GEN.KLOUD	HUMANS
GEN.KLOUD	THE HIVE
Hyper	Spoiler - Original Mix
KLOUD	ERROR
LRKR	Coffee Beans
No Mana, Chipzel	Secret Level
Party Favor	Too Much
Perturbator	Birth of the New Model
Phuture Doom	Han Breaks
Remi Gallego	Malware Injection
Remi Gallego	Panic Track
Revenant	get out of my head
Throwing Snow, Py	As You Fall
Zebbler Encanti Experience	Exit Stance
feeding | ear	Outrun The Wolves