Artist	Title
2touch	Want2
Alex Banks, Maya Wolff	Elevate - Edit
Ambassadeurs	Clarion
Arlo, Emi Grace	Besides You
Baalti, Tom VR	Staying In Touch - Tom VR Sunrise Mix
Bob Moses, CRi	Hanging On - CRi Remix
Braxton	Spaces
CRi, Bernache	From Me
CRi, Bernache	From Me - CRi Remix
CRi, Sophia Bel, Jesse Mac Cormack	Memories - Jesse Mac Cormack Remix
DJ_Dave	Castles
DOT5	Neverland
Devault	I Will
Duskus	Better
EMBRZ	lOnDn
False Noise	Greys
Flint	Feel the Air
Floating Points	Key103 [a56 edit]
French 79	FOIX
Froman	No More
Golden Features, Rromarin, Solomun	Touch - Solomun Remix
Jai Wolf, BANKS, Mild Minds	Don't Look Down (feat. BANKS) [Mild Minds Remix]
Jasper Tygner	All I Need
Jasper Tygner, just lil	Strangers Around (feat. just lil)
Jerry Folk, Izza Gara	Don't You
Jersey	Talk Tonight
John Tejada	The End Of It All 2015 Mix
Juno Mamba	undrcut
KH, Solomun	Looking at Your Pager - Solomun Remix
Kidnap	Birds That Fly
Kidnap, Dwara	Fortified
Knapsack	Synth Grass
Lexer	Sunshinerain
Lugovskiy	Go Through Everything
Maribou State, Holly Walker	Steal
Miso Extra, DJ BORING	Slow Down - Single Version
Model Man	Arms
Mord Fustang	Flower With No Name
Ordley	4EVA
Overmono, Ruthven	Gem Lingo (ovr now)
PolSky, Vessels	Song for the Silver Surfer - Vessels Mix
Pretty Girl	Arc
Pretty Girl	Empathy
Pretty Girl	Forever
SWIM	Condition
SWIM	First Day of the Year
SWIM	Out There
Sideluv	The Collection
Siriusmo	High Together
Swimming Paul	Lost
The Micronaut	Bobsleigh
Tom VR, Midland	Soared Straight Through Me - Midland Remix
YSI	Shake well before use
YULLOLA	Hold onto Me
wes mills	nintendo 64