Artist	Title
20syl, Alligatorz, Ron Puma, DJ Greem	Pra Ver Você Sambar - 20Syl Remix
Airelle Besson, Benjamin Moussay, Fabrice Moreau	The Sound of Your Voice, Pt. II
Android52	Over the Clouds
Aṣa	Jailer
Bad Computer, Bianca	Land of the Living
Bakermat, GoldFish, Marie Plassard	Games Continued (feat. Marie Plassard) - Radio Edit
Bakermat, Nic Hanson	Walk That Walk
Bakermat, Rhys Lewis	Good Feeling (feat. Rhys Lewis)
Bakermat, Ron Carroll	Life (feat. Ron Carroll)
Bernhoft, C2C	Shout - C2C Remix (Long Version)
Blue Foster	IDK If I'm a Boy
Blur	Song 2
Breakbot, Irfane	Baby I'm Yours
C2C	Delta
C2C	Down The Road
Cola Boyy, The Avalanches	Don't Forget Your Neighborhood
Corinne Bailey Rae	Put Your Records On
DROELOE, Banji	Landscape
Digitalism	Blink
Digitalism	Second Chance - Capa Remix
Dov'è Liana	Time to dance
Dtwice	Devil's Tune - 20Syl Remix
EKKSTACY	mr. mole
False Noise	Jewel Crust
False Noise	Majesty
Feist	Mushaboom
Frizk	ALL MY FELLAS
Gen Hoshino	Comedy
Geotic	Actually Smiling
Gregory Porter, 20syl	Liquid Spirit - 20syl Remix
Halfbrick	Jetpack Joyride Main Theme (Original Game Soundtrack)
Infected Mushroom	Never Mind
JAY-Z, Alicia Keys	Empire State Of Mind
Jamiroquai	Virtual Insanity - Remastered 2006
Joachim Pastor, Mischa	Fever
Joe Hisaishi	The Village in May
Klangkarussell	Netzwerk (Falls Like Rain)
Magdalena Bay	Death & Romance
Maribou State	Beginner's Luck
Natalie Layne	Love Me Back to Life
Nhato	Gekka
Phoenix	1901
Phoenix	Lasso
Porter Robinson	Cheerleader
Portugal. The Man	Feel It Still
RetroVision	FamilyMart
RetroVision	Puzzle - 2024 Edit
Stessie	Atmosphere
Stessie	Because of You
The Offspring	The Kids Aren't Alright
TheFatRat	Unity
Tomggg, raychel jay	Away With Me
Vampire Weekend	A-Punk
WRLD, Savoi	Chase It
WRLD, Veronika Redd	Little Too Close
clammbon	Lush Life!
clammbon	raison dale
deadmau5, Benny Benassi, Gary Go, BYNX	The Veldt Cinema - BYNX Edit
ヨルシカ	ただ君に晴れ
ヨルシカ	爆弾魔 - Re-Recording
中村佳穂	きっとね！
中村佳穂	祝辞