Artist	Title
AUST	The Hive
Aests	DUCK GROOVE
Afternoon Bike Ride	Terrace Rain
Ahadadream, Priya Ragu, Skrillex, Taiki Nulight	TAKA - Taiki Nulight Remix
Aloboi	Dies Irae
Arman Cekin, eevee	Mysterious Ambience
Auvic, CENTRL	Ethereal Field
Bailey Baum, Flawed Mangoes	Take Me All The Way - Flawed Mangoes Remix
Bby Eco	⥀.003 Zoom
Blackbird	Regrets
Bnj, BOKI	Toi & Moi - BOKI Remix
C.H.A.Y.	FIRE EMBLEM
Cella	Drowning
Cospe	System Error
Danger	Astro
Effin	Divine
El Tigr3	Fomalhaut
Ellzo	Sunday Sauce
Emray	About 10 Hours of Making Breakcore
Ephilexia	Grassland
Ernest Gonzales	Etchasketch Trees
FM Skyline	Harlequin
Flying Lotus	Garmonbozia
Groupthink	does your mother know?
Ian Mills	yayarave
Ichika Nito	The World is Still Beautiful
Imprintafter	Simple & Clean - imprintafter flip
JUST JAMES	Looking Up
Jacana People	Painting On Glass
James Ivy	Texas
Jass Yang	Lonely Island
Jimmy Whoo	Satin Dolls
Klangphonics	Great Plains
Kouek	Dice Game
Kumo 99	Headplate
Lord Genmu, The Glitch Mob	Hold It - The Glitch Mob Remix
Lorn	ENTROPYYY
MaybeImTyler	you again
Mindchatter	It's Ok (it's Not Ok)
Neon Vectors	NV House
Nikita, the Wicked	holy ghost
Peterparker69, Tennyson	skyskysky
RFM Beats	3 minute
Rad Cat	leave it all behind
Rohaan	Easy for them
Saya Gray	AA BOUQUET FOR YOUR 180 FACE
Silent Boy, defyer, yaego	Show U
Skyr0	disintegrate
Tal Richards, Sheepy, Hahlweg	A Journey's Pace
Tomáš Dvořák, C418	The Sea - C418 Remix
VESHZA	Freeway
Veela	Versatile
Village	DUNIYA
Xizt	Drowning
boy 2000	zero
maxime.	‎telephone ‎wires
who am I if not a —	my tv is broken
yaego	EUROPA
yaego	constant repeat
yeule	sulky baby