Artist	Title
ATB, Morten Granau	Ecstasy - Morten Granau Remix
Aiobahn, yanaginagi, Magnificence	Re: searchlight - Magnificence Remix
Alle Farben, ILIRA, Deepend	Fading - Deepend Remix
Arden Jones	mr. sunshine
Bad Computer	Sanctuary
Clark	Town Crank
Daniel Joshua, Charles Oliver	Hivemind - Charles Oliver Remix
Deorro	Five Hours - Original Mix
Disclosure	Never Enough
Duskus	My Heart
Eekkoo	Eleven
Extrawelt	Jetzt Neu: Alles Wie Früher
Extrawelt, Harald Björk	Doch Doch - The Lost 2007 Harald Björk Remix
FROZT	Never Before
Feiertag	When She Leaves
Fred again.., The Blessed Madonna	Marea (we’ve lost dancing)
Funkin Matt	Juncture
Geoxor	I Like You
Habstrakt, Unlovable	The One - Unlovable Remix
Julian Gray, Pipa Moran, Dezza	Touch - Dezza Remix
Kasbo	World Away
Lane 8	Rave
Lane 8, Arctic Lake	What Have You Done To Me?
Le Matos	Playtime Is Over
Leo Janeiro, Gui Boratto, Rodriguez Jr.	MooDisco - Rodriguez Jr. Remix
M.A.N.D.Y., Pete Tong	Tonite - Pete Tong Remix
Marley Carroll	Shiver
Mild Minds	DOPAMINE
Mire.	Bury
Montell2099, XIRA, Sublab	Exodia
Mr. Bill	Loaf Boi
Mr. Bill, Skope, Zebbler Encanti Experience	2020 - Zebbler Encanti Experience Remix
M|O|O|N	Alicia - Single Version
Navie D	Cave Crawl
Niven, Throwing Snow	Rositsa Walks - Throwing Snow Remix
No Mana	Yesterday
No Mana, Olivera	My Way To You (feat. Olivera)
ODESZA, Låpsley	Equal
Pedestrian Tactics	Nerds Trying To Dance
Pig&Dan, Siavash	Call The Hitman
Point Point, Samaran	Hands - Samaran Remix
REVERSE	To The Edge
Solee, Unique Repeat	Phoenix - Unique Repeat Remix
Stephan Bodzin, Luna Semara, Agents Of Time	Nothing Like You - Agents Of Time Remix
Stereoclip	HLTA - Bonus Track
Sublab, JiLLi	Sick of Saying Sorry (with JiLLi)
Sysdemes	Syndicate
Sysdemes, Syberlilly	Laminae
Throwing Snow, Kid A	Hypnotise
Tinlicker	All That I Lost
Tinlicker	Bird Feeder
Tinlicker, Helsloot, Hero Baldwin	Tell Me
Yedgar	Never Say Goodbye
k?d, Cecilia Gault	THREE IN THE MORNING